2200000000
0202222220
0212011020
0222000020
0000222120
0000212220
0222200000
1200122220
0222220021
0000000022